Id,Report_Id,Total_Test_Cases,Total_Test_Passed,Total_Test_Failed,Tag_Name,Time_Stamp
1,1,23,20,3,Balance,20210108 06:30:49.418
2,1,2,0,2,BillMix,20210108 06:30:49.418
3,1,1,1,0,CardBeforeCash,20210108 06:30:49.418
4,1,24,24,0,CashDeposit,20210108 06:30:49.418
5,1,1,1,0,Chaining,20210108 06:30:49.418
6,1,1,1,0,ChainingDisable,20210108 06:30:49.418
7,1,4,0,4,CheckDeposit,20210108 06:30:49.418
8,1,1,0,1,Deletepreferences,20210108 06:30:49.418
9,1,1,0,1,DepositContinuation,20210108 06:30:49.418
10,1,2,2,0,DynamicTextVG,20210108 06:30:49.418
11,1,2,2,0,Electronicpayment,20210108 06:30:49.418
12,1,3,3,0,EndDeposit,20210108 06:30:49.418
13,1,1,1,0,EnhancedDeposit,20210108 06:30:49.418
14,1,21,21,0,FastCash,20210108 06:30:49.418
15,1,26,25,1,Fee,20210108 06:30:49.418
16,1,4,3,1,GenericTransaction,20210108 06:30:49.418
17,1,38,28,10,Good,20210108 06:30:49.418
18,1,20,19,1,HostDenial,20210108 06:30:49.418
19,1,2,2,0,IB,20210108 06:30:49.418
20,1,2,2,0,MiniStatement,20210108 06:30:49.418
21,1,1,0,1,MixedMedia,20210108 06:30:49.418
22,1,1,0,1,MixedMediaDeposit,20210108 06:30:49.418
23,1,2,2,0,MultiLanguage,20210108 06:30:49.418
24,1,2,0,2,NDCPreferences,20210108 06:30:49.418
25,1,1,1,0,NonGrouping,20210108 06:30:49.418
26,1,17,16,1,OAR,20210108 06:30:49.418
27,1,2,2,0,Pinchange,20210108 06:30:49.418
28,1,53,38,15,Sanity,20210108 06:30:49.418
29,1,25,24,1,Transfer,20210108 06:30:49.418
30,1,5,4,1,Unchained,20210108 06:30:49.418
31,1,31,31,0,UserError,20210108 06:30:49.418
32,1,22,21,1,Withdrawal,20210108 06:30:49.418
33,2,23,20,3,Balance,20210108 14:49:32.943
34,2,2,0,2,BillMix,20210108 14:49:32.943
35,2,1,1,0,CardBeforeCash,20210108 14:49:32.943
36,2,24,24,0,CashDeposit,20210108 14:49:32.943
37,2,1,1,0,Chaining,20210108 14:49:32.943
38,2,1,1,0,ChainingDisable,20210108 14:49:32.943
39,2,4,0,4,CheckDeposit,20210108 14:49:32.943
40,2,1,0,1,Deletepreferences,20210108 14:49:32.943
41,2,1,0,1,DepositContinuation,20210108 14:49:32.943
42,2,2,2,0,DynamicTextVG,20210108 14:49:32.943
43,2,2,2,0,Electronicpayment,20210108 14:49:32.943
44,2,3,3,0,EndDeposit,20210108 14:49:32.943
45,2,1,1,0,EnhancedDeposit,20210108 14:49:32.943
46,2,21,19,2,FastCash,20210108 14:49:32.943
47,2,26,25,1,Fee,20210108 14:49:32.943
48,2,4,3,1,GenericTransaction,20210108 14:49:32.943
49,2,38,28,10,Good,20210108 14:49:32.943
50,2,20,19,1,HostDenial,20210108 14:49:32.943
51,2,2,2,0,IB,20210108 14:49:32.943
52,2,2,2,0,MiniStatement,20210108 14:49:32.943
53,2,1,0,1,MixedMedia,20210108 14:49:32.943
54,2,1,0,1,MixedMediaDeposit,20210108 14:49:32.943
55,2,2,2,0,MultiLanguage,20210108 14:49:32.943
56,2,2,0,2,NDCPreferences,20210108 14:49:32.943
57,2,1,1,0,NonGrouping,20210108 14:49:32.943
58,2,17,16,1,OAR,20210108 14:49:32.943
59,2,2,2,0,Pinchange,20210108 14:49:32.943
60,2,53,38,15,Sanity,20210108 14:49:32.943
61,2,25,25,0,Transfer,20210108 14:49:32.943
62,2,5,5,0,Unchained,20210108 14:49:32.943
63,2,31,31,0,UserError,20210108 14:49:32.943
64,2,22,22,0,Withdrawal,20210108 14:49:32.943
65,3,23,20,3,Balance,20210109 02:00:01.774
66,3,2,0,2,BillMix,20210109 02:00:01.774
67,3,1,1,0,CardBeforeCash,20210109 02:00:01.774
68,3,24,24,0,CashDeposit,20210109 02:00:01.774
69,3,1,1,0,Chaining,20210109 02:00:01.774
70,3,1,1,0,ChainingDisable,20210109 02:00:01.774
71,3,4,0,4,CheckDeposit,20210109 02:00:01.774
72,3,1,0,1,Deletepreferences,20210109 02:00:01.774
73,3,1,0,1,DepositContinuation,20210109 02:00:01.774
74,3,2,2,0,DynamicTextVG,20210109 02:00:01.774
75,3,2,2,0,Electronicpayment,20210109 02:00:01.774
76,3,3,3,0,EndDeposit,20210109 02:00:01.774
77,3,1,1,0,EnhancedDeposit,20210109 02:00:01.774
78,3,21,21,0,FastCash,20210109 02:00:01.774
79,3,26,25,1,Fee,20210109 02:00:01.774
80,3,4,3,1,GenericTransaction,20210109 02:00:01.774
81,3,38,29,9,Good,20210109 02:00:01.774
82,3,20,18,2,HostDenial,20210109 02:00:01.774
83,3,2,2,0,IB,20210109 02:00:01.774
84,3,2,2,0,MiniStatement,20210109 02:00:01.774
85,3,1,0,1,MixedMedia,20210109 02:00:01.774
86,3,1,0,1,MixedMediaDeposit,20210109 02:00:01.774
87,3,2,2,0,MultiLanguage,20210109 02:00:01.774
88,3,2,0,2,NDCPreferences,20210109 02:00:01.774
89,3,1,1,0,NonGrouping,20210109 02:00:01.774
90,3,17,16,1,OAR,20210109 02:00:01.774
91,3,2,1,1,Pinchange,20210109 02:00:01.774
92,3,53,38,15,Sanity,20210109 02:00:01.774
93,3,25,24,1,Transfer,20210109 02:00:01.774
94,3,5,4,1,Unchained,20210109 02:00:01.774
95,3,31,31,0,UserError,20210109 02:00:01.774
96,3,22,22,0,Withdrawal,20210109 02:00:01.774
97,4,23,20,3,Balance,20210109 06:19:03.454
98,4,2,0,2,BillMix,20210109 06:19:03.454
99,4,1,1,0,CardBeforeCash,20210109 06:19:03.454
100,4,24,24,0,CashDeposit,20210109 06:19:03.454
101,4,1,1,0,Chaining,20210109 06:19:03.454
102,4,1,1,0,ChainingDisable,20210109 06:19:03.454
103,4,4,0,4,CheckDeposit,20210109 06:19:03.454
104,4,1,0,1,Deletepreferences,20210109 06:19:03.454
105,4,1,0,1,DepositContinuation,20210109 06:19:03.454
106,4,2,2,0,DynamicTextVG,20210109 06:19:03.454
107,4,2,2,0,Electronicpayment,20210109 06:19:03.454
108,4,3,1,2,EndDeposit,20210109 06:19:03.454
109,4,1,1,0,EnhancedDeposit,20210109 06:19:03.454
110,4,21,20,1,FastCash,20210109 06:19:03.454
111,4,26,25,1,Fee,20210109 06:19:03.454
112,4,4,3,1,GenericTransaction,20210109 06:19:03.454
113,4,38,26,12,Good,20210109 06:19:03.454
114,4,20,18,2,HostDenial,20210109 06:19:03.454
115,4,2,2,0,IB,20210109 06:19:03.454
116,4,2,2,0,MiniStatement,20210109 06:19:03.454
117,4,1,0,1,MixedMedia,20210109 06:19:03.454
118,4,1,0,1,MixedMediaDeposit,20210109 06:19:03.454
119,4,2,2,0,MultiLanguage,20210109 06:19:03.454
120,4,2,0,2,NDCPreferences,20210109 06:19:03.454
121,4,1,0,1,NonGrouping,20210109 06:19:03.454
122,4,17,16,1,OAR,20210109 06:19:03.454
123,4,2,1,1,Pinchange,20210109 06:19:03.454
124,4,53,35,18,Sanity,20210109 06:19:03.454
125,4,25,24,1,Transfer,20210109 06:19:03.454
126,4,5,4,1,Unchained,20210109 06:19:03.454
127,4,31,31,0,UserError,20210109 06:19:03.454
128,4,22,22,0,Withdrawal,20210109 06:19:03.454
129,5,23,20,3,Balance,20210110 22:06:38.625
130,5,2,0,2,BillMix,20210110 22:06:38.625
131,5,1,1,0,CardBeforeCash,20210110 22:06:38.625
132,5,24,23,1,CashDeposit,20210110 22:06:38.625
133,5,1,1,0,Chaining,20210110 22:06:38.625
134,5,1,1,0,ChainingDisable,20210110 22:06:38.625
135,5,4,0,4,CheckDeposit,20210110 22:06:38.625
136,5,1,0,1,Deletepreferences,20210110 22:06:38.625
137,5,1,0,1,DepositContinuation,20210110 22:06:38.625
138,5,2,1,1,DynamicTextVG,20210110 22:06:38.625
139,5,2,2,0,Electronicpayment,20210110 22:06:38.625
140,5,3,3,0,EndDeposit,20210110 22:06:38.625
141,5,1,1,0,EnhancedDeposit,20210110 22:06:38.625
142,5,21,20,1,FastCash,20210110 22:06:38.625
143,5,26,25,1,Fee,20210110 22:06:38.625
144,5,4,3,1,GenericTransaction,20210110 22:06:38.625
145,5,38,28,10,Good,20210110 22:06:38.625
146,5,20,17,3,HostDenial,20210110 22:06:38.625
147,5,2,2,0,IB,20210110 22:06:38.625
148,5,2,2,0,MiniStatement,20210110 22:06:38.625
149,5,1,0,1,MixedMedia,20210110 22:06:38.625
150,5,1,0,1,MixedMediaDeposit,20210110 22:06:38.625
151,5,2,2,0,MultiLanguage,20210110 22:06:38.625
152,5,2,0,2,NDCPreferences,20210110 22:06:38.625
153,5,1,1,0,NonGrouping,20210110 22:06:38.625
154,5,17,16,1,OAR,20210110 22:06:38.625
155,5,2,1,1,Pinchange,20210110 22:06:38.625
156,5,53,36,17,Sanity,20210110 22:06:38.625
157,5,25,24,1,Transfer,20210110 22:06:38.625
158,5,5,4,1,Unchained,20210110 22:06:38.625
159,5,31,31,0,UserError,20210110 22:06:38.625
160,5,22,22,0,Withdrawal,20210110 22:06:38.625
161,6,23,16,7,Balance,20210118 15:40:11.373
162,6,2,2,0,BillMix,20210118 15:40:11.373
163,6,1,1,0,CardBeforeCash,20210118 15:40:11.373
164,6,24,23,1,CashDeposit,20210118 15:40:11.373
165,6,1,1,0,Chaining,20210118 15:40:11.373
166,6,1,1,0,ChainingDisable,20210118 15:40:11.373
167,6,4,0,4,CheckDeposit,20210118 15:40:11.373
168,6,1,0,1,Deletepreferences,20210118 15:40:11.373
169,6,1,0,1,DepositContinuation,20210118 15:40:11.373
170,6,2,2,0,DynamicTextVG,20210118 15:40:11.373
171,6,2,2,0,Electronicpayment,20210118 15:40:11.373
172,6,3,3,0,EndDeposit,20210118 15:40:11.373
173,6,1,1,0,EnhancedDeposit,20210118 15:40:11.373
174,6,21,21,0,FastCash,20210118 15:40:11.373
175,6,26,25,1,Fee,20210118 15:40:11.373
176,6,4,4,0,GenericTransaction,20210118 15:40:11.373
177,6,38,32,6,Good,20210118 15:40:11.373
178,6,20,14,6,HostDenial,20210118 15:40:11.373
179,6,2,2,0,IB,20210118 15:40:11.373
180,6,2,2,0,MiniStatement,20210118 15:40:11.373
181,6,1,0,1,MixedMedia,20210118 15:40:11.373
182,6,1,0,1,MixedMediaDeposit,20210118 15:40:11.373
183,6,2,2,0,MultiLanguage,20210118 15:40:11.373
184,6,2,0,2,NDCPreferences,20210118 15:40:11.373
185,6,1,1,0,NonGrouping,20210118 15:40:11.373
186,6,17,16,1,OAR,20210118 15:40:11.373
187,6,2,1,1,Pinchange,20210118 15:40:11.373
188,6,53,41,12,Sanity,20210118 15:40:11.373
189,6,25,25,0,Transfer,20210118 15:40:11.373
190,6,5,5,0,Unchained,20210118 15:40:11.373
191,6,31,30,1,UserError,20210118 15:40:11.373
192,6,22,21,1,Withdrawal,20210118 15:40:11.373
193,7,23,17,6,Balance,20210119 09:57:04.921
194,7,2,0,2,BillMix,20210119 09:57:04.921
195,7,1,1,0,CardBeforeCash,20210119 09:57:04.921
196,7,24,24,0,CashDeposit,20210119 09:57:04.921
197,7,1,1,0,Chaining,20210119 09:57:04.921
198,7,1,1,0,ChainingDisable,20210119 09:57:04.921
199,7,4,0,4,CheckDeposit,20210119 09:57:04.921
200,7,1,0,1,Deletepreferences,20210119 09:57:04.921
201,7,1,0,1,DepositContinuation,20210119 09:57:04.921
202,7,2,2,0,DynamicTextVG,20210119 09:57:04.921
203,7,2,1,1,Electronicpayment,20210119 09:57:04.921
204,7,3,3,0,EndDeposit,20210119 09:57:04.921
205,7,1,1,0,EnhancedDeposit,20210119 09:57:04.921
206,7,21,21,0,FastCash,20210119 09:57:04.921
207,7,26,25,1,Fee,20210119 09:57:04.921
208,7,4,3,1,GenericTransaction,20210119 09:57:04.921
209,7,38,29,9,Good,20210119 09:57:04.921
210,7,20,14,6,HostDenial,20210119 09:57:04.921
211,7,2,1,1,IB,20210119 09:57:04.921
212,7,2,2,0,MiniStatement,20210119 09:57:04.921
213,7,1,0,1,MixedMedia,20210119 09:57:04.921
214,7,1,0,1,MixedMediaDeposit,20210119 09:57:04.921
215,7,2,2,0,MultiLanguage,20210119 09:57:04.921
216,7,2,0,2,NDCPreferences,20210119 09:57:04.921
217,7,1,1,0,NonGrouping,20210119 09:57:04.921
218,7,17,16,1,OAR,20210119 09:57:04.921
219,7,2,1,1,Pinchange,20210119 09:57:04.921
220,7,53,36,17,Sanity,20210119 09:57:04.921
221,7,25,24,1,Transfer,20210119 09:57:04.921
222,7,5,4,1,Unchained,20210119 09:57:04.921
223,7,31,31,0,UserError,20210119 09:57:04.921
224,7,22,21,1,Withdrawal,20210119 09:57:04.921
225,8,23,19,4,Balance,20210119 19:49:27.230
226,8,2,0,2,BillMix,20210119 19:49:27.230
227,8,1,1,0,CardBeforeCash,20210119 19:49:27.230
228,8,24,24,0,CashDeposit,20210119 19:49:27.230
229,8,1,1,0,Chaining,20210119 19:49:27.230
230,8,1,1,0,ChainingDisable,20210119 19:49:27.230
231,8,4,0,4,CheckDeposit,20210119 19:49:27.230
232,8,1,0,1,Deletepreferences,20210119 19:49:27.230
233,8,1,0,1,DepositContinuation,20210119 19:49:27.230
234,8,2,2,0,DynamicTextVG,20210119 19:49:27.230
235,8,2,1,1,Electronicpayment,20210119 19:49:27.230
236,8,3,3,0,EndDeposit,20210119 19:49:27.230
237,8,1,1,0,EnhancedDeposit,20210119 19:49:27.230
238,8,21,21,0,FastCash,20210119 19:49:27.230
239,8,26,25,1,Fee,20210119 19:49:27.230
240,8,4,3,1,GenericTransaction,20210119 19:49:27.230
241,8,38,29,9,Good,20210119 19:49:27.230
242,8,20,15,5,HostDenial,20210119 19:49:27.230
243,8,2,1,1,IB,20210119 19:49:27.230
244,8,2,2,0,MiniStatement,20210119 19:49:27.230
245,8,1,0,1,MixedMedia,20210119 19:49:27.230
246,8,1,0,1,MixedMediaDeposit,20210119 19:49:27.230
247,8,2,2,0,MultiLanguage,20210119 19:49:27.230
248,8,2,0,2,NDCPreferences,20210119 19:49:27.230
249,8,1,1,0,NonGrouping,20210119 19:49:27.230
250,8,17,16,1,OAR,20210119 19:49:27.230
251,8,2,1,1,Pinchange,20210119 19:49:27.230
252,8,53,36,17,Sanity,20210119 19:49:27.230
253,8,25,23,2,Transfer,20210119 19:49:27.230
254,8,5,3,2,Unchained,20210119 19:49:27.230
255,8,31,31,0,UserError,20210119 19:49:27.230
256,8,22,21,1,Withdrawal,20210119 19:49:27.230
257,9,23,19,4,Balance,20210121 13:36:05.741
258,9,3,0,3,BillMix,20210121 13:36:05.741
259,9,6,6,0,CardBeforeCash,20210121 13:36:05.741
260,9,36,35,1,CashDeposit,20210121 13:36:05.741
261,9,1,1,0,Chaining,20210121 13:36:05.741
262,9,1,1,0,ChainingDisable,20210121 13:36:05.741
263,9,4,0,4,CheckDeposit,20210121 13:36:05.741
264,9,13,13,0,DCC,20210121 13:36:05.741
265,9,2,2,0,DCCGood,20210121 13:36:05.741
266,9,7,7,0,DCCVISA,20210121 13:36:05.741
267,9,1,0,1,Deletepreferences,20210121 13:36:05.741
268,9,1,0,1,DepositContinuation,20210121 13:36:05.741
269,9,2,2,0,DynamicSubAccount,20210121 13:36:05.741
270,9,2,2,0,DynamicTextVG,20210121 13:36:05.741
271,9,2,2,0,Electronicpayment,20210121 13:36:05.741
272,9,3,3,0,EndDeposit,20210121 13:36:05.741
273,9,1,1,0,EnhancedDeposit,20210121 13:36:05.741
274,9,46,44,2,FastCash,20210121 13:36:05.741
275,9,70,69,1,Fee,20210121 13:36:05.741
276,9,4,3,1,GenericTransaction,20210121 13:36:05.741
277,9,46,35,11,Good,20210121 13:36:05.741
278,9,26,21,5,HostDenial,20210121 13:36:05.741
279,9,2,2,0,IB,20210121 13:36:05.741
280,9,1,1,0,InvalidHostData,20210121 13:36:05.741
281,9,2,2,0,MiniStatement,20210121 13:36:05.741
282,9,1,0,1,MixedMedia,20210121 13:36:05.741
283,9,1,0,1,MixedMediaDeposit,20210121 13:36:05.741
284,9,2,2,0,MultiLanguage,20210121 13:36:05.741
285,9,2,0,2,NDCPreferences,20210121 13:36:05.741
286,9,2,1,1,NonGrouping,20210121 13:36:05.741
287,9,33,32,1,OAR,20210121 13:36:05.741
288,9,2,2,0,Pinchange,20210121 13:36:05.741
289,9,56,41,15,Sanity,20210121 13:36:05.741
290,9,24,23,1,Transfer,20210121 13:36:05.741
291,9,4,3,1,Unchained,20210121 13:36:05.741
292,9,34,34,0,UserError,20210121 13:36:05.741
293,9,77,76,1,Withdrawal,20210121 13:36:05.741
294,9,1,1,0,Withdrawal Fee timeout,20210121 13:36:05.741
295,10,23,17,6,Balance,20210122 05:41:23.097
296,10,3,2,1,BillMix,20210122 05:41:23.097
297,10,6,6,0,CardBeforeCash,20210122 05:41:23.097
298,10,36,35,1,CashDeposit,20210122 05:41:23.097
299,10,1,1,0,Chaining,20210122 05:41:23.097
300,10,1,1,0,ChainingDisable,20210122 05:41:23.097
301,10,4,0,4,CheckDeposit,20210122 05:41:23.097
302,10,13,12,1,DCC,20210122 05:41:23.097
303,10,2,2,0,DCCGood,20210122 05:41:23.097
304,10,7,7,0,DCCVISA,20210122 05:41:23.097
305,10,1,0,1,Deletepreferences,20210122 05:41:23.097
306,10,1,0,1,DepositContinuation,20210122 05:41:23.097
307,10,2,2,0,DynamicSubAccount,20210122 05:41:23.097
308,10,2,2,0,Electronicpayment,20210122 05:41:23.097
309,10,3,3,0,EndDeposit,20210122 05:41:23.097
310,10,1,1,0,EnhancedDeposit,20210122 05:41:23.097
311,10,46,45,1,FastCash,20210122 05:41:23.097
312,10,70,69,1,Fee,20210122 05:41:23.097
313,10,4,3,1,GenericTransaction,20210122 05:41:23.097
314,10,46,38,8,Good,20210122 05:41:23.097
315,10,26,19,7,HostDenial,20210122 05:41:23.097
316,10,2,2,0,IB,20210122 05:41:23.097
317,10,1,1,0,InvalidHostData,20210122 05:41:23.097
318,10,2,2,0,MiniStatement,20210122 05:41:23.097
319,10,1,0,1,MixedMedia,20210122 05:41:23.097
320,10,1,0,1,MixedMediaDeposit,20210122 05:41:23.097
321,10,2,2,0,MultiLanguage,20210122 05:41:23.097
322,10,2,0,2,NDCPreferences,20210122 05:41:23.097
323,10,2,2,0,NonGrouping,20210122 05:41:23.097
324,10,33,32,1,OAR,20210122 05:41:23.097
325,10,2,1,1,Pinchange,20210122 05:41:23.097
326,10,54,40,14,Sanity,20210122 05:41:23.097
327,10,24,23,1,Transfer,20210122 05:41:23.097
328,10,4,3,1,Unchained,20210122 05:41:23.097
329,10,34,34,0,UserError,20210122 05:41:23.097
330,10,77,77,0,Withdrawal,20210122 05:41:23.097
331,10,1,1,0,Withdrawal Fee timeout,20210122 05:41:23.097
332,11,23,20,3,Balance,20210123 12:23:46.343
333,11,3,0,3,BillMix,20210123 12:23:46.343
334,11,6,6,0,CardBeforeCash,20210123 12:23:46.343
335,11,36,36,0,CashDeposit,20210123 12:23:46.343
336,11,3,2,1,Chained,20210123 12:23:46.343
337,11,1,1,0,Chaining,20210123 12:23:46.343
338,11,1,1,0,ChainingDisable,20210123 12:23:46.343
339,11,4,0,4,CheckDeposit,20210123 12:23:46.343
340,11,13,13,0,DCC,20210123 12:23:46.343
341,11,2,2,0,DCCGood,20210123 12:23:46.343
342,11,8,8,0,DCCVISA,20210123 12:23:46.343
343,11,1,0,1,Deletepreferences,20210123 12:23:46.343
344,11,1,0,1,DepositContinuation,20210123 12:23:46.343
345,11,2,2,0,DynamicSubAccount,20210123 12:23:46.343
346,11,2,1,1,Electronicpayment,20210123 12:23:46.343
347,11,1,0,1,EMV,20210123 12:23:46.343
348,11,3,3,0,EndDeposit,20210123 12:23:46.343
349,11,2,1,1,EnhancedDeposit,20210123 12:23:46.343
350,11,47,47,0,FastCash,20210123 12:23:46.343
351,11,70,69,1,Fee,20210123 12:23:46.343
352,11,4,4,0,GenericTransaction,20210123 12:23:46.343
353,11,48,37,11,Good,20210123 12:23:46.343
354,11,29,25,4,HostDenial,20210123 12:23:46.343
355,11,2,2,0,IB,20210123 12:23:46.343
356,11,2,2,0,InvalidHostData,20210123 12:23:46.343
357,11,2,2,0,MiniStatement,20210123 12:23:46.343
358,11,1,0,1,MixedMedia,20210123 12:23:46.343
359,11,1,0,1,MixedMediaDeposit,20210123 12:23:46.343
360,11,2,2,0,MultiLanguage,20210123 12:23:46.343
361,11,2,0,2,NDCPreferences,20210123 12:23:46.343
362,11,2,2,0,NonGrouping,20210123 12:23:46.343
363,11,33,31,2,OAR,20210123 12:23:46.343
364,11,2,2,0,Pinchange,20210123 12:23:46.343
365,11,57,40,17,Sanity,20210123 12:23:46.343
366,11,27,23,4,Transfer,20210123 12:23:46.343
367,11,4,2,2,Unchained,20210123 12:23:46.343
368,11,34,34,0,UserError,20210123 12:23:46.343
369,11,77,77,0,Withdrawal,20210123 12:23:46.343
370,11,1,1,0,Withdrawal Fee timeout,20210123 12:23:46.343
371,12,23,18,5,Balance,20210124 08:03:19.398
372,12,3,0,3,BillMix,20210124 08:03:19.398
373,12,6,6,0,CardBeforeCash,20210124 08:03:19.398
374,12,36,36,0,CashDeposit,20210124 08:03:19.398
375,12,3,2,1,Chained,20210124 08:03:19.398
376,12,1,1,0,Chaining,20210124 08:03:19.398
377,12,1,1,0,ChainingDisable,20210124 08:03:19.398
378,12,4,0,4,CheckDeposit,20210124 08:03:19.398
379,12,13,13,0,DCC,20210124 08:03:19.398
380,12,2,2,0,DCCGood,20210124 08:03:19.398
381,12,8,8,0,DCCVISA,20210124 08:03:19.398
382,12,1,0,1,Deletepreferences,20210124 08:03:19.398
383,12,1,0,1,DepositContinuation,20210124 08:03:19.398
384,12,2,2,0,DynamicSubAccount,20210124 08:03:19.398
385,12,2,2,0,DynamicTextVG,20210124 08:03:19.398
386,12,2,1,1,Electronicpayment,20210124 08:03:19.398
387,12,1,0,1,EMV,20210124 08:03:19.398
388,12,3,3,0,EndDeposit,20210124 08:03:19.398
389,12,2,1,1,EnhancedDeposit,20210124 08:03:19.398
390,12,47,45,2,FastCash,20210124 08:03:19.398
391,12,70,69,1,Fee,20210124 08:03:19.398
392,12,4,3,1,GenericTransaction,20210124 08:03:19.398
393,12,48,35,13,Good,20210124 08:03:19.398
394,12,29,21,8,HostDenial,20210124 08:03:19.398
395,12,2,2,0,IB,20210124 08:03:19.398
396,12,2,2,0,InvalidHostData,20210124 08:03:19.398
397,12,2,2,0,MiniStatement,20210124 08:03:19.398
398,12,1,0,1,MixedMedia,20210124 08:03:19.398
399,12,1,0,1,MixedMediaDeposit,20210124 08:03:19.398
400,12,2,2,0,MultiLanguage,20210124 08:03:19.398
401,12,2,0,2,NDCPreferences,20210124 08:03:19.398
402,12,2,1,1,NonGrouping,20210124 08:03:19.398
403,12,33,32,1,OAR,20210124 08:03:19.398
404,12,2,2,0,Pinchange,20210124 08:03:19.398
405,12,59,41,18,Sanity,20210124 08:03:19.398
406,12,27,24,3,Transfer,20210124 08:03:19.398
407,12,4,2,2,Unchained,20210124 08:03:19.398
408,12,34,34,0,UserError,20210124 08:03:19.398
409,12,77,76,1,Withdrawal,20210124 08:03:19.398
410,12,1,1,0,Withdrawal Fee timeout,20210124 08:03:19.398
411,13,23,20,3,Balance,20210124 22:14:33.537
412,13,3,0,3,BillMix,20210124 22:14:33.537
413,13,6,6,0,CardBeforeCash,20210124 22:14:33.537
414,13,36,36,0,CashDeposit,20210124 22:14:33.537
415,13,3,2,1,Chained,20210124 22:14:33.537
416,13,1,1,0,Chaining,20210124 22:14:33.537
417,13,1,1,0,ChainingDisable,20210124 22:14:33.537
418,13,4,0,4,CheckDeposit,20210124 22:14:33.537
419,13,13,12,1,DCC,20210124 22:14:33.537
420,13,2,2,0,DCCGood,20210124 22:14:33.537
421,13,8,8,0,DCCVISA,20210124 22:14:33.537
422,13,1,0,1,Deletepreferences,20210124 22:14:33.537
423,13,1,0,1,DepositContinuation,20210124 22:14:33.537
424,13,2,2,0,DynamicSubAccount,20210124 22:14:33.537
425,13,2,2,0,DynamicTextVG,20210124 22:14:33.537
426,13,2,2,0,Electronicpayment,20210124 22:14:33.537
427,13,1,0,1,EMV,20210124 22:14:33.537
428,13,3,3,0,EndDeposit,20210124 22:14:33.537
429,13,2,1,1,EnhancedDeposit,20210124 22:14:33.537
430,13,47,47,0,FastCash,20210124 22:14:33.537
431,13,70,69,1,Fee,20210124 22:14:33.537
432,13,4,3,1,GenericTransaction,20210124 22:14:33.537
433,13,48,36,12,Good,20210124 22:14:33.537
434,13,29,25,4,HostDenial,20210124 22:14:33.537
435,13,2,2,0,IB,20210124 22:14:33.537
436,13,2,2,0,InvalidHostData,20210124 22:14:33.537
437,13,2,2,0,MiniStatement,20210124 22:14:33.537
438,13,1,0,1,MixedMedia,20210124 22:14:33.537
439,13,1,0,1,MixedMediaDeposit,20210124 22:14:33.537
440,13,2,2,0,MultiLanguage,20210124 22:14:33.537
441,13,2,0,2,NDCPreferences,20210124 22:14:33.537
442,13,2,2,0,NonGrouping,20210124 22:14:33.537
443,13,33,32,1,OAR,20210124 22:14:33.537
444,13,2,2,0,Pinchange,20210124 22:14:33.537
445,13,59,41,18,Sanity,20210124 22:14:33.537
446,13,27,26,1,Transfer,20210124 22:14:33.537
447,13,4,4,0,Unchained,20210124 22:14:33.537
448,13,34,34,0,UserError,20210124 22:14:33.537
449,13,77,74,3,Withdrawal,20210124 22:14:33.537
450,13,1,1,0,Withdrawal Fee timeout,20210124 22:14:33.537
451,14,23,17,6,Balance,20210125 19:39:50.737
452,14,3,0,3,BillMix,20210125 19:39:50.737
453,14,6,6,0,CardBeforeCash,20210125 19:39:50.737
454,14,36,35,1,CashDeposit,20210125 19:39:50.737
455,14,3,3,0,Chained,20210125 19:39:50.737
456,14,1,1,0,Chaining,20210125 19:39:50.737
457,14,1,1,0,ChainingDisable,20210125 19:39:50.737
458,14,4,0,4,CheckDeposit,20210125 19:39:50.737
459,14,13,12,1,DCC,20210125 19:39:50.737
460,14,2,2,0,DCCGood,20210125 19:39:50.737
461,14,8,7,1,DCCVISA,20210125 19:39:50.737
462,14,1,0,1,Deletepreferences,20210125 19:39:50.737
463,14,1,0,1,DepositContinuation,20210125 19:39:50.737
464,14,2,2,0,DynamicSubAccount,20210125 19:39:50.737
465,14,2,2,0,DynamicTextVG,20210125 19:39:50.737
466,14,2,2,0,Electronicpayment,20210125 19:39:50.737
467,14,1,0,1,EMV,20210125 19:39:50.737
468,14,3,3,0,EndDeposit,20210125 19:39:50.737
469,14,2,1,1,EnhancedDeposit,20210125 19:39:50.737
470,14,47,46,1,FastCash,20210125 19:39:50.737
471,14,70,69,1,Fee,20210125 19:39:50.737
472,14,4,3,1,GenericTransaction,20210125 19:39:50.737
473,14,48,34,14,Good,20210125 19:39:50.737
474,14,29,24,5,HostDenial,20210125 19:39:50.737
475,14,2,1,1,IB,20210125 19:39:50.737
476,14,2,2,0,InvalidHostData,20210125 19:39:50.737
477,14,2,2,0,MiniStatement,20210125 19:39:50.737
478,14,1,0,1,MixedMedia,20210125 19:39:50.737
479,14,1,0,1,MixedMediaDeposit,20210125 19:39:50.737
480,14,2,2,0,MultiLanguage,20210125 19:39:50.737
481,14,2,0,2,NDCPreferences,20210125 19:39:50.737
482,14,2,1,1,NonGrouping,20210125 19:39:50.737
483,14,33,32,1,OAR,20210125 19:39:50.737
484,14,2,2,0,Pinchange,20210125 19:39:50.737
485,14,59,40,19,Sanity,20210125 19:39:50.737
486,14,27,27,0,Transfer,20210125 19:39:50.737
487,14,4,4,0,Unchained,20210125 19:39:50.737
488,14,34,34,0,UserError,20210125 19:39:50.737
489,14,77,73,4,Withdrawal,20210125 19:39:50.737
490,14,1,1,0,Withdrawal Fee timeout,20210125 19:39:50.737
491,15,23,14,9,Balance,20210126 08:19:15.061
492,15,3,0,3,BillMix,20210126 08:19:15.061
493,15,6,6,0,CardBeforeCash,20210126 08:19:15.061
494,15,36,31,5,CashDeposit,20210126 08:19:15.061
495,15,3,3,0,Chained,20210126 08:19:15.061
496,15,1,0,1,Chaining,20210126 08:19:15.061
497,15,1,0,1,ChainingDisable,20210126 08:19:15.061
498,15,4,0,4,CheckDeposit,20210126 08:19:15.061
499,15,13,13,0,DCC,20210126 08:19:15.061
500,15,2,2,0,DCCGood,20210126 08:19:15.061
501,15,8,8,0,DCCVISA,20210126 08:19:15.061
502,15,1,0,1,Deletepreferences,20210126 08:19:15.061
503,15,1,0,1,DepositContinuation,20210126 08:19:15.061
504,15,2,2,0,DynamicSubAccount,20210126 08:19:15.061
505,15,2,0,2,DynamicTextVG,20210126 08:19:15.061
506,15,2,0,2,Electronicpayment,20210126 08:19:15.061
507,15,1,0,1,EMV,20210126 08:19:15.061
508,15,3,0,3,EndDeposit,20210126 08:19:15.061
509,15,2,0,2,EnhancedDeposit,20210126 08:19:15.061
510,15,47,42,5,FastCash,20210126 08:19:15.061
511,15,70,62,8,Fee,20210126 08:19:15.061
512,15,4,0,4,GenericTransaction,20210126 08:19:15.061
513,15,48,13,35,Good,20210126 08:19:15.061
514,15,29,21,8,HostDenial,20210126 08:19:15.061
515,15,2,0,2,IB,20210126 08:19:15.061
516,15,2,2,0,InvalidHostData,20210126 08:19:15.061
517,15,2,0,2,MiniStatement,20210126 08:19:15.061
518,15,1,0,1,MixedMedia,20210126 08:19:15.061
519,15,1,0,1,MixedMediaDeposit,20210126 08:19:15.061
520,15,2,0,2,MultiLanguage,20210126 08:19:15.061
521,15,2,0,2,NDCPreferences,20210126 08:19:15.061
522,15,2,0,2,NonGrouping,20210126 08:19:15.061
523,15,33,31,2,OAR,20210126 08:19:15.061
524,15,2,0,2,Pinchange,20210126 08:19:15.061
525,15,59,3,56,Sanity,20210126 08:19:15.061
526,15,27,19,8,Transfer,20210126 08:19:15.061
527,15,4,2,2,Unchained,20210126 08:19:15.061
528,15,34,34,0,UserError,20210126 08:19:15.061
529,15,77,71,6,Withdrawal,20210126 08:19:15.061
530,15,1,1,0,Withdrawal Fee timeout,20210126 08:19:15.061
531,16,23,13,10,Balance,20210127 21:40:56.120
532,16,3,0,3,BillMix,20210127 21:40:56.120
533,16,6,5,1,CardBeforeCash,20210127 21:40:56.120
534,16,36,30,6,CashDeposit,20210127 21:40:56.120
535,16,3,1,2,Chained,20210127 21:40:56.120
536,16,1,0,1,Chaining,20210127 21:40:56.120
537,16,1,0,1,ChainingDisable,20210127 21:40:56.120
538,16,4,0,4,CheckDeposit,20210127 21:40:56.120
539,16,13,12,1,DCC,20210127 21:40:56.120
540,16,2,2,0,DCCGood,20210127 21:40:56.120
541,16,8,8,0,DCCVISA,20210127 21:40:56.120
542,16,1,0,1,Deletepreferences,20210127 21:40:56.120
543,16,1,0,1,DepositContinuation,20210127 21:40:56.120
544,16,2,2,0,DynamicSubAccount,20210127 21:40:56.120
545,16,2,0,2,DynamicTextVG,20210127 21:40:56.120
546,16,2,0,2,Electronicpayment,20210127 21:40:56.120
547,16,1,0,1,EMV,20210127 21:40:56.120
548,16,3,0,3,EndDeposit,20210127 21:40:56.120
549,16,2,0,2,EnhancedDeposit,20210127 21:40:56.120
550,16,47,39,8,FastCash,20210127 21:40:56.120
551,16,70,62,8,Fee,20210127 21:40:56.120
552,16,4,0,4,GenericTransaction,20210127 21:40:56.120
553,16,48,12,36,Good,20210127 21:40:56.120
554,16,29,17,12,HostDenial,20210127 21:40:56.120
555,16,2,0,2,IB,20210127 21:40:56.120
556,16,2,2,0,InvalidHostData,20210127 21:40:56.120
557,16,2,0,2,MiniStatement,20210127 21:40:56.120
558,16,1,0,1,MixedMedia,20210127 21:40:56.120
559,16,1,0,1,MixedMediaDeposit,20210127 21:40:56.120
560,16,2,0,2,MultiLanguage,20210127 21:40:56.120
561,16,2,0,2,NDCPreferences,20210127 21:40:56.120
562,16,2,0,2,NonGrouping,20210127 21:40:56.120
563,16,33,31,2,OAR,20210127 21:40:56.120
564,16,2,0,2,Pinchange,20210127 21:40:56.120
565,16,59,2,57,Sanity,20210127 21:40:56.120
566,16,27,18,9,Transfer,20210127 21:40:56.120
567,16,4,3,1,Unchained,20210127 21:40:56.120
568,16,34,33,1,UserError,20210127 21:40:56.120
569,16,77,71,6,Withdrawal,20210127 21:40:56.120
570,16,1,1,0,Withdrawal Fee timeout,20210127 21:40:56.120
571,17,23,20,3,Balance,20210128 22:37:15.222
572,17,3,0,3,BillMix,20210128 22:37:15.222
573,17,6,6,0,CardBeforeCash,20210128 22:37:15.222
574,17,36,35,1,CashDeposit,20210128 22:37:15.222
575,17,3,2,1,Chained,20210128 22:37:15.222
576,17,1,1,0,Chaining,20210128 22:37:15.222
577,17,1,1,0,ChainingDisable,20210128 22:37:15.222
578,17,4,0,4,CheckDeposit,20210128 22:37:15.222
579,17,13,11,2,DCC,20210128 22:37:15.222
580,17,2,0,2,DCCGood,20210128 22:37:15.222
581,17,8,7,1,DCCVISA,20210128 22:37:15.222
582,17,1,0,1,Deletepreferences,20210128 22:37:15.222
583,17,1,0,1,DepositContinuation,20210128 22:37:15.222
584,17,2,2,0,DynamicSubAccount,20210128 22:37:15.222
585,17,2,2,0,DynamicTextVG,20210128 22:37:15.222
586,17,2,2,0,Electronicpayment,20210128 22:37:15.222
587,17,1,0,1,EMV,20210128 22:37:15.222
588,17,3,3,0,EndDeposit,20210128 22:37:15.222
589,17,2,1,1,EnhancedDeposit,20210128 22:37:15.222
590,17,47,42,5,FastCash,20210128 22:37:15.222
591,17,70,67,3,Fee,20210128 22:37:15.222
592,17,4,3,1,GenericTransaction,20210128 22:37:15.222
593,17,48,36,12,Good,20210128 22:37:15.222
594,17,29,26,3,HostDenial,20210128 22:37:15.222
595,17,2,2,0,IB,20210128 22:37:15.222
596,17,2,2,0,InvalidHostData,20210128 22:37:15.222
597,17,2,2,0,MiniStatement,20210128 22:37:15.222
598,17,1,0,1,MixedMedia,20210128 22:37:15.222
599,17,1,0,1,MixedMediaDeposit,20210128 22:37:15.222
600,17,2,2,0,MultiLanguage,20210128 22:37:15.222
601,17,2,0,2,NDCPreferences,20210128 22:37:15.222
602,17,2,2,0,NonGrouping,20210128 22:37:15.222
603,17,33,32,1,OAR,20210128 22:37:15.222
604,17,2,1,1,Pinchange,20210128 22:37:15.222
605,17,59,41,18,Sanity,20210128 22:37:15.222
606,17,27,26,1,Transfer,20210128 22:37:15.222
607,17,4,4,0,Unchained,20210128 22:37:15.222
608,17,34,33,1,UserError,20210128 22:37:15.222
609,17,77,76,1,Withdrawal,20210128 22:37:15.222
610,17,1,1,0,Withdrawal Fee timeout,20210128 22:37:15.222
611,18,23,19,4,Balance,20210201 15:01:30.938
612,18,3,0,3,BillMix,20210201 15:01:30.938
613,18,6,6,0,CardBeforeCash,20210201 15:01:30.938
614,18,36,35,1,CashDeposit,20210201 15:01:30.938
615,18,3,2,1,Chained,20210201 15:01:30.938
616,18,1,1,0,Chaining,20210201 15:01:30.938
617,18,1,1,0,ChainingDisable,20210201 15:01:30.938
618,18,4,0,4,CheckDeposit,20210201 15:01:30.938
619,18,13,10,3,DCC,20210201 15:01:30.938
620,18,2,2,0,DCCGood,20210201 15:01:30.938
621,18,8,8,0,DCCVISA,20210201 15:01:30.938
622,18,1,0,1,Deletepreferences,20210201 15:01:30.938
623,18,1,0,1,DepositContinuation,20210201 15:01:30.938
624,18,2,2,0,DynamicSubAccount,20210201 15:01:30.938
625,18,2,2,0,DynamicTextVG,20210201 15:01:30.938
626,18,2,2,0,Electronicpayment,20210201 15:01:30.938
627,18,1,0,1,EMV,20210201 15:01:30.938
628,18,3,3,0,EndDeposit,20210201 15:01:30.938
629,18,2,1,1,EnhancedDeposit,20210201 15:01:30.938
630,18,47,46,1,FastCash,20210201 15:01:30.938
631,18,70,69,1,Fee,20210201 15:01:30.938
632,18,4,3,1,GenericTransaction,20210201 15:01:30.938
633,18,48,35,13,Good,20210201 15:01:30.938
634,18,29,21,8,HostDenial,20210201 15:01:30.938
635,18,2,1,1,IB,20210201 15:01:30.938
636,18,2,2,0,InvalidHostData,20210201 15:01:30.938
637,18,2,2,0,MiniStatement,20210201 15:01:30.938
638,18,1,0,1,MixedMedia,20210201 15:01:30.938
639,18,1,0,1,MixedMediaDeposit,20210201 15:01:30.938
640,18,2,2,0,MultiLanguage,20210201 15:01:30.938
641,18,2,0,2,NDCPreferences,20210201 15:01:30.938
642,18,2,2,0,NonGrouping,20210201 15:01:30.938
643,18,33,31,2,OAR,20210201 15:01:30.938
644,18,2,2,0,Pinchange,20210201 15:01:30.938
645,18,59,40,19,Sanity,20210201 15:01:30.938
646,18,27,24,3,Transfer,20210201 15:01:30.938
647,18,4,2,2,Unchained,20210201 15:01:30.938
648,18,34,34,0,UserError,20210201 15:01:30.938
649,18,77,72,5,Withdrawal,20210201 15:01:30.938
650,18,1,1,0,Withdrawal Fee timeout,20210201 15:01:30.938
651,19,23,17,6,Balance,20210201 23:01:37.225
652,19,3,0,3,BillMix,20210201 23:01:37.225
653,19,6,6,0,CardBeforeCash,20210201 23:01:37.225
654,19,36,35,1,CashDeposit,20210201 23:01:37.225
655,19,3,0,3,Chained,20210201 23:01:37.225
656,19,1,1,0,Chaining,20210201 23:01:37.225
657,19,1,1,0,ChainingDisable,20210201 23:01:37.225
658,19,4,0,4,CheckDeposit,20210201 23:01:37.225
659,19,13,12,1,DCC,20210201 23:01:37.225
660,19,2,2,0,DCCGood,20210201 23:01:37.225
661,19,8,8,0,DCCVISA,20210201 23:01:37.225
662,19,1,0,1,Deletepreferences,20210201 23:01:37.225
663,19,1,0,1,DepositContinuation,20210201 23:01:37.225
664,19,2,2,0,DynamicSubAccount,20210201 23:01:37.225
665,19,2,2,0,DynamicTextVG,20210201 23:01:37.225
666,19,2,2,0,Electronicpayment,20210201 23:01:37.225
667,19,1,0,1,EMV,20210201 23:01:37.225
668,19,3,3,0,EndDeposit,20210201 23:01:37.225
669,19,2,1,1,EnhancedDeposit,20210201 23:01:37.225
670,19,47,45,2,FastCash,20210201 23:01:37.225
671,19,70,69,1,Fee,20210201 23:01:37.225
672,19,4,3,1,GenericTransaction,20210201 23:01:37.225
673,19,48,35,13,Good,20210201 23:01:37.225
674,19,29,18,11,HostDenial,20210201 23:01:37.225
675,19,2,0,2,IB,20210201 23:01:37.225
676,19,2,2,0,InvalidHostData,20210201 23:01:37.225
677,19,2,2,0,MiniStatement,20210201 23:01:37.225
678,19,1,0,1,MixedMedia,20210201 23:01:37.225
679,19,1,0,1,MixedMediaDeposit,20210201 23:01:37.225
680,19,2,2,0,MultiLanguage,20210201 23:01:37.225
681,19,2,0,2,NDCPreferences,20210201 23:01:37.225
682,19,2,2,0,NonGrouping,20210201 23:01:37.225
683,19,33,31,2,OAR,20210201 23:01:37.225
684,19,2,2,0,Pinchange,20210201 23:01:37.225
685,19,59,38,21,Sanity,20210201 23:01:37.225
686,19,27,23,4,Transfer,20210201 23:01:37.225
687,19,4,3,1,Unchained,20210201 23:01:37.225
688,19,34,34,0,UserError,20210201 23:01:37.225
689,19,77,72,5,Withdrawal,20210201 23:01:37.225
690,19,1,1,0,Withdrawal Fee timeout,20210201 23:01:37.225
691,20,23,19,4,Balance,20210202 22:04:00.273
692,20,3,0,3,BillMix,20210202 22:04:00.273
693,20,6,6,0,CardBeforeCash,20210202 22:04:00.273
694,20,36,36,0,CashDeposit,20210202 22:04:00.273
695,20,3,1,2,Chained,20210202 22:04:00.273
696,20,1,1,0,Chaining,20210202 22:04:00.273
697,20,1,1,0,ChainingDisable,20210202 22:04:00.273
698,20,4,0,4,CheckDeposit,20210202 22:04:00.273
699,20,13,11,2,DCC,20210202 22:04:00.273
700,20,2,2,0,DCCGood,20210202 22:04:00.273
701,20,8,8,0,DCCVISA,20210202 22:04:00.273
702,20,1,0,1,Deletepreferences,20210202 22:04:00.273
703,20,1,0,1,DepositContinuation,20210202 22:04:00.273
704,20,2,2,0,DynamicSubAccount,20210202 22:04:00.273
705,20,2,2,0,DynamicTextVG,20210202 22:04:00.273
706,20,2,2,0,Electronicpayment,20210202 22:04:00.273
707,20,1,0,1,EMV,20210202 22:04:00.273
708,20,3,3,0,EndDeposit,20210202 22:04:00.273
709,20,2,1,1,EnhancedDeposit,20210202 22:04:00.273
710,20,47,47,0,FastCash,20210202 22:04:00.273
711,20,70,69,1,Fee,20210202 22:04:00.273
712,20,4,3,1,GenericTransaction,20210202 22:04:00.273
713,20,48,36,12,Good,20210202 22:04:00.273
714,20,29,19,10,HostDenial,20210202 22:04:00.273
715,20,2,1,1,IB,20210202 22:04:00.273
716,20,2,2,0,InvalidHostData,20210202 22:04:00.273
717,20,2,2,0,MiniStatement,20210202 22:04:00.273
718,20,1,0,1,MixedMedia,20210202 22:04:00.273
719,20,1,0,1,MixedMediaDeposit,20210202 22:04:00.273
720,20,2,2,0,MultiLanguage,20210202 22:04:00.273
721,20,2,0,2,NDCPreferences,20210202 22:04:00.273
722,20,2,2,0,NonGrouping,20210202 22:04:00.273
723,20,33,32,1,OAR,20210202 22:04:00.273
724,20,2,1,1,Pinchange,20210202 22:04:00.273
725,20,59,40,19,Sanity,20210202 22:04:00.273
726,20,27,24,3,Transfer,20210202 22:04:00.273
727,20,4,3,1,Unchained,20210202 22:04:00.273
728,20,34,34,0,UserError,20210202 22:04:00.273
729,20,77,71,6,Withdrawal,20210202 22:04:00.273
730,20,1,1,0,Withdrawal Fee timeout,20210202 22:04:00.273
731,21,23,17,6,Balance,20210204 18:40:48.516
732,21,3,0,3,BillMix,20210204 18:40:48.516
733,21,6,6,0,CardBeforeCash,20210204 18:40:48.516
734,21,36,36,0,CashDeposit,20210204 18:40:48.516
735,21,3,2,1,Chained,20210204 18:40:48.516
736,21,1,1,0,Chaining,20210204 18:40:48.516
737,21,1,1,0,ChainingDisable,20210204 18:40:48.516
738,21,4,0,4,CheckDeposit,20210204 18:40:48.516
739,21,13,11,2,DCC,20210204 18:40:48.516
740,21,2,2,0,DCCGood,20210204 18:40:48.516
741,21,8,8,0,DCCVISA,20210204 18:40:48.516
742,21,1,0,1,Deletepreferences,20210204 18:40:48.516
743,21,1,0,1,DepositContinuation,20210204 18:40:48.516
744,21,2,2,0,DynamicSubAccount,20210204 18:40:48.516
745,21,2,2,0,DynamicTextVG,20210204 18:40:48.516
746,21,2,1,1,Electronicpayment,20210204 18:40:48.516
747,21,1,0,1,EMV,20210204 18:40:48.516
748,21,3,3,0,EndDeposit,20210204 18:40:48.516
749,21,2,1,1,EnhancedDeposit,20210204 18:40:48.516
750,21,47,46,1,FastCash,20210204 18:40:48.516
751,21,70,69,1,Fee,20210204 18:40:48.516
752,21,4,3,1,GenericTransaction,20210204 18:40:48.516
753,21,48,36,12,Good,20210204 18:40:48.516
754,21,29,19,10,HostDenial,20210204 18:40:48.516
755,21,2,1,1,IB,20210204 18:40:48.516
756,21,2,2,0,InvalidHostData,20210204 18:40:48.516
757,21,2,2,0,MiniStatement,20210204 18:40:48.516
758,21,1,0,1,MixedMedia,20210204 18:40:48.516
759,21,1,0,1,MixedMediaDeposit,20210204 18:40:48.516
760,21,2,2,0,MultiLanguage,20210204 18:40:48.516
761,21,2,0,2,NDCPreferences,20210204 18:40:48.516
762,21,2,2,0,NonGrouping,20210204 18:40:48.516
763,21,33,32,1,OAR,20210204 18:40:48.516
764,21,2,1,1,Pinchange,20210204 18:40:48.516
765,21,59,38,21,Sanity,20210204 18:40:48.516
766,21,27,24,3,Transfer,20210204 18:40:48.516
767,21,4,2,2,Unchained,20210204 18:40:48.516
768,21,34,34,0,UserError,20210204 18:40:48.516
769,21,77,75,2,Withdrawal,20210204 18:40:48.516
770,21,1,1,0,Withdrawal Fee timeout,20210204 18:40:48.516
771,22,23,18,5,Balance,20210206 10:30:35.351
772,22,3,0,3,BillMix,20210206 10:30:35.351
773,22,6,6,0,CardBeforeCash,20210206 10:30:35.351
774,22,36,35,1,CashDeposit,20210206 10:30:35.351
775,22,3,1,2,Chained,20210206 10:30:35.351
776,22,1,1,0,Chaining,20210206 10:30:35.351
777,22,1,1,0,ChainingDisable,20210206 10:30:35.351
778,22,4,0,4,CheckDeposit,20210206 10:30:35.351
779,22,13,13,0,DCC,20210206 10:30:35.351
780,22,2,2,0,DCCGood,20210206 10:30:35.351
781,22,8,8,0,DCCVISA,20210206 10:30:35.351
782,22,1,0,1,Deletepreferences,20210206 10:30:35.351
783,22,1,0,1,DepositContinuation,20210206 10:30:35.351
784,22,2,2,0,DynamicSubAccount,20210206 10:30:35.351
785,22,2,2,0,DynamicTextVG,20210206 10:30:35.351
786,22,2,2,0,Electronicpayment,20210206 10:30:35.351
787,22,1,0,1,EMV,20210206 10:30:35.351
788,22,3,3,0,EndDeposit,20210206 10:30:35.351
789,22,2,1,1,EnhancedDeposit,20210206 10:30:35.351
790,22,47,47,0,FastCash,20210206 10:30:35.351
791,22,70,69,1,Fee,20210206 10:30:35.351
792,22,4,3,1,GenericTransaction,20210206 10:30:35.351
793,22,48,36,12,Good,20210206 10:30:35.351
794,22,29,24,5,HostDenial,20210206 10:30:35.351
795,22,2,0,2,IB,20210206 10:30:35.351
796,22,2,2,0,InvalidHostData,20210206 10:30:35.351
797,22,2,2,0,MiniStatement,20210206 10:30:35.351
798,22,1,0,1,MixedMedia,20210206 10:30:35.351
799,22,1,0,1,MixedMediaDeposit,20210206 10:30:35.351
800,22,2,2,0,MultiLanguage,20210206 10:30:35.351
801,22,2,0,2,NDCPreferences,20210206 10:30:35.351
802,22,2,2,0,NonGrouping,20210206 10:30:35.351
803,22,33,32,1,OAR,20210206 10:30:35.351
804,22,2,2,0,Pinchange,20210206 10:30:35.351
805,22,59,40,19,Sanity,20210206 10:30:35.351
806,22,27,24,3,Transfer,20210206 10:30:35.351
807,22,4,3,1,Unchained,20210206 10:30:35.351
808,22,34,34,0,UserError,20210206 10:30:35.351
809,22,77,76,1,Withdrawal,20210206 10:30:35.351
810,22,1,1,0,Withdrawal Fee timeout,20210206 10:30:35.351
811,23,23,19,4,Balance,20210207 16:09:54.613
812,23,3,0,3,BillMix,20210207 16:09:54.613
813,23,6,6,0,CardBeforeCash,20210207 16:09:54.613
814,23,36,35,1,CashDeposit,20210207 16:09:54.613
815,23,3,1,2,Chained,20210207 16:09:54.613
816,23,1,1,0,Chaining,20210207 16:09:54.613
817,23,1,1,0,ChainingDisable,20210207 16:09:54.613
818,23,4,0,4,CheckDeposit,20210207 16:09:54.613
819,23,13,12,1,DCC,20210207 16:09:54.613
820,23,2,2,0,DCCGood,20210207 16:09:54.613
821,23,8,7,1,DCCVISA,20210207 16:09:54.613
822,23,1,0,1,Deletepreferences,20210207 16:09:54.613
823,23,1,0,1,DepositContinuation,20210207 16:09:54.613
824,23,2,2,0,DynamicSubAccount,20210207 16:09:54.613
825,23,2,2,0,DynamicTextVG,20210207 16:09:54.613
826,23,2,2,0,Electronicpayment,20210207 16:09:54.613
827,23,1,0,1,EMV,20210207 16:09:54.613
828,23,3,3,0,EndDeposit,20210207 16:09:54.613
829,23,2,1,1,EnhancedDeposit,20210207 16:09:54.613
830,23,47,45,2,FastCash,20210207 16:09:54.613
831,23,70,69,1,Fee,20210207 16:09:54.613
832,23,4,3,1,GenericTransaction,20210207 16:09:54.613
833,23,48,36,12,Good,20210207 16:09:54.613
834,23,29,20,9,HostDenial,20210207 16:09:54.613
835,23,2,1,1,IB,20210207 16:09:54.613
836,23,2,2,0,InvalidHostData,20210207 16:09:54.613
837,23,2,2,0,MiniStatement,20210207 16:09:54.613
838,23,1,0,1,MixedMedia,20210207 16:09:54.613
839,23,1,0,1,MixedMediaDeposit,20210207 16:09:54.613
840,23,2,2,0,MultiLanguage,20210207 16:09:54.613
841,23,2,0,2,NDCPreferences,20210207 16:09:54.613
842,23,2,2,0,NonGrouping,20210207 16:09:54.613
843,23,33,32,1,OAR,20210207 16:09:54.613
844,23,2,2,0,Pinchange,20210207 16:09:54.613
845,23,59,40,19,Sanity,20210207 16:09:54.613
846,23,27,24,3,Transfer,20210207 16:09:54.613
847,23,4,3,1,Unchained,20210207 16:09:54.613
848,23,34,34,0,UserError,20210207 16:09:54.613
849,23,77,73,4,Withdrawal,20210207 16:09:54.613
850,23,1,1,0,Withdrawal Fee timeout,20210207 16:09:54.613
851,24,23,18,5,Balance,20210224 11:08:50.640
852,24,3,2,1,BillMix,20210224 11:08:50.640
853,24,6,5,1,CardBeforeCash,20210224 11:08:50.640
854,24,36,36,0,CashDeposit,20210224 11:08:50.640
855,24,3,1,2,Chained,20210224 11:08:50.640
856,24,1,1,0,Chaining,20210224 11:08:50.640
857,24,1,1,0,ChainingDisable,20210224 11:08:50.640
858,24,4,0,4,CheckDeposit,20210224 11:08:50.640
859,24,13,11,2,DCC,20210224 11:08:50.640
860,24,2,2,0,DCCGood,20210224 11:08:50.640
861,24,8,8,0,DCCVISA,20210224 11:08:50.640
862,24,1,0,1,Deletepreferences,20210224 11:08:50.640
863,24,1,0,1,DepositContinuation,20210224 11:08:50.640
864,24,2,2,0,DynamicSubAccount,20210224 11:08:50.640
865,24,2,2,0,DynamicTextVG,20210224 11:08:50.640
866,24,2,2,0,Electronicpayment,20210224 11:08:50.640
867,24,1,0,1,EMV,20210224 11:08:50.640
868,24,3,3,0,EndDeposit,20210224 11:08:50.640
869,24,2,1,1,EnhancedDeposit,20210224 11:08:50.640
870,24,47,45,2,FastCash,20210224 11:08:50.640
871,24,70,69,1,Fee,20210224 11:08:50.640
872,24,4,3,1,GenericTransaction,20210224 11:08:50.640
873,24,48,37,11,Good,20210224 11:08:50.640
874,24,29,21,8,HostDenial,20210224 11:08:50.640
875,24,2,0,2,IB,20210224 11:08:50.640
876,24,2,2,0,InvalidHostData,20210224 11:08:50.640
877,24,2,2,0,MiniStatement,20210224 11:08:50.640
878,24,1,0,1,MixedMedia,20210224 11:08:50.640
879,24,1,0,1,MixedMediaDeposit,20210224 11:08:50.640
880,24,2,2,0,MultiLanguage,20210224 11:08:50.640
881,24,2,0,2,NDCPreferences,20210224 11:08:50.640
882,24,2,2,0,NonGrouping,20210224 11:08:50.640
883,24,33,32,1,OAR,20210224 11:08:50.640
884,24,2,2,0,Pinchange,20210224 11:08:50.640
885,24,59,41,18,Sanity,20210224 11:08:50.640
886,24,27,23,4,Transfer,20210224 11:08:50.640
887,24,4,2,2,Unchained,20210224 11:08:50.640
888,24,34,34,0,UserError,20210224 11:08:50.640
889,24,77,74,3,Withdrawal,20210224 11:08:50.640
890,24,1,1,0,Withdrawal Fee timeout,20210224 11:08:50.640
891,25,23,20,3,Balance,20210305 12:39:57.059
892,25,3,0,3,BillMix,20210305 12:39:57.059
893,25,6,6,0,CardBeforeCash,20210305 12:39:57.059
894,25,36,36,0,CashDeposit,20210305 12:39:57.059
895,25,3,2,1,Chained,20210305 12:39:57.059
896,25,1,1,0,Chaining,20210305 12:39:57.059
897,25,1,1,0,ChainingDisable,20210305 12:39:57.059
898,25,4,0,4,CheckDeposit,20210305 12:39:57.059
899,25,13,13,0,DCC,20210305 12:39:57.059
900,25,2,2,0,DCCGood,20210305 12:39:57.059
901,25,8,8,0,DCCVISA,20210305 12:39:57.059
902,25,1,0,1,Deletepreferences,20210305 12:39:57.059
903,25,1,0,1,DepositContinuation,20210305 12:39:57.059
904,25,2,2,0,DynamicSubAccount,20210305 12:39:57.059
905,25,2,2,0,DynamicTextVG,20210305 12:39:57.059
906,25,2,1,1,Electronicpayment,20210305 12:39:57.059
907,25,1,0,1,EMV,20210305 12:39:57.059
908,25,3,3,0,EndDeposit,20210305 12:39:57.059
909,25,2,1,1,EnhancedDeposit,20210305 12:39:57.059
910,25,47,47,0,FastCash,20210305 12:39:57.059
911,25,70,69,1,Fee,20210305 12:39:57.059
912,25,4,3,1,GenericTransaction,20210305 12:39:57.059
913,25,48,36,12,Good,20210305 12:39:57.059
914,25,29,25,4,HostDenial,20210305 12:39:57.059
915,25,2,1,1,IB,20210305 12:39:57.059
916,25,2,2,0,InvalidHostData,20210305 12:39:57.059
917,25,2,2,0,MiniStatement,20210305 12:39:57.059
918,25,1,0,1,MixedMedia,20210305 12:39:57.059
919,25,1,0,1,MixedMediaDeposit,20210305 12:39:57.059
920,25,2,2,0,MultiLanguage,20210305 12:39:57.059
921,25,2,0,2,NDCPreferences,20210305 12:39:57.059
922,25,2,2,0,NonGrouping,20210305 12:39:57.059
923,25,33,31,2,OAR,20210305 12:39:57.059
924,25,2,2,0,Pinchange,20210305 12:39:57.059
925,25,59,39,20,Sanity,20210305 12:39:57.059
926,25,27,25,2,Transfer,20210305 12:39:57.059
927,25,4,3,1,Unchained,20210305 12:39:57.059
928,25,34,34,0,UserError,20210305 12:39:57.059
929,25,77,74,3,Withdrawal,20210305 12:39:57.059
930,25,1,1,0,Withdrawal Fee timeout,20210305 12:39:57.059
988,28,23,22,1,Balance,20210105 14:44:17.444
989,28,2,0,2,BillMix,20210105 14:44:17.444
990,28,1,1,0,CardBeforeCash,20210105 14:44:17.444
991,28,24,24,0,CashDeposit,20210105 14:44:17.444
992,28,1,1,0,CashPayment,20210105 14:44:17.444
993,28,1,1,0,Chaining,20210105 14:44:17.444
994,28,1,1,0,ChainingDisable,20210105 14:44:17.444
995,28,4,0,4,CheckDeposit,20210105 14:44:17.444
996,28,2,0,2,CheckPayment,20210105 14:44:17.444
997,28,1,1,0,Deletepreferences,20210105 14:44:17.444
998,28,1,0,1,DepositContinuation,20210105 14:44:17.444
999,28,2,2,0,Electronicpayment,20210105 14:44:17.444
1000,28,3,3,0,EndDeposit,20210105 14:44:17.444
1001,28,1,1,0,EnhancedDeposit,20210105 14:44:17.444
1002,28,21,20,1,FastCash,20210105 14:44:17.444
1003,28,26,26,0,Fee,20210105 14:44:17.444
1004,28,4,3,1,GenericTransaction,20210105 14:44:17.444
1005,28,41,32,9,Good,20210105 14:44:17.444
1006,28,20,15,5,HostDenial,20210105 14:44:17.444
1007,28,2,0,2,IB,20210105 14:44:17.444
1008,28,2,2,0,MiniStatement,20210105 14:44:17.444
1009,28,3,3,0,MiniStatementMultiplePages,20210105 14:44:17.444
1010,28,1,0,1,MixedMedia,20210105 14:44:17.444
1011,28,1,0,1,MixedMediaDeposit,20210105 14:44:17.444
1012,28,2,2,0,MultiLanguage,20210105 14:44:17.444
1013,28,2,2,0,NDCPreferences,20210105 14:44:17.444
1014,28,1,1,0,NonGrouping,20210105 14:44:17.444
1015,28,17,16,1,OAR,20210105 14:44:17.444
1016,28,2,2,0,Pinchange,20210105 14:44:17.444
1017,28,57,44,13,Sanity,20210105 14:44:17.444
1018,28,25,21,4,Transfer,20210105 14:44:17.444
1019,28,5,1,4,Unchained,20210105 14:44:17.444
1020,28,31,31,0,UserError,20210105 14:44:17.444
1021,28,22,21,1,Withdrawal,20210105 14:44:17.444
1022,29,23,23,0,Balance,20210106 12:48:46.156
1023,29,2,0,2,BillMix,20210106 12:48:46.156
1024,29,1,1,0,CardBeforeCash,20210106 12:48:46.156
1025,29,24,24,0,CashDeposit,20210106 12:48:46.156
1026,29,1,1,0,CashPayment,20210106 12:48:46.156
1027,29,1,1,0,Chaining,20210106 12:48:46.156
1028,29,1,1,0,ChainingDisable,20210106 12:48:46.156
1029,29,4,0,4,CheckDeposit,20210106 12:48:46.156
1030,29,2,0,2,CheckPayment,20210106 12:48:46.156
1031,29,1,1,0,Deletepreferences,20210106 12:48:46.156
1032,29,1,0,1,DepositContinuation,20210106 12:48:46.156
1033,29,2,2,0,DynamicTextVG,20210106 12:48:46.156
1034,29,2,2,0,Electronicpayment,20210106 12:48:46.156
1035,29,3,3,0,EndDeposit,20210106 12:48:46.156
1036,29,1,1,0,EnhancedDeposit,20210106 12:48:46.156
1037,29,21,20,1,FastCash,20210106 12:48:46.156
1038,29,26,26,0,Fee,20210106 12:48:46.156
1039,29,4,4,0,GenericTransaction,20210106 12:48:46.156
1040,29,41,33,8,Good,20210106 12:48:46.156
1041,29,20,18,2,HostDenial,20210106 12:48:46.156
1042,29,2,2,0,IB,20210106 12:48:46.156
1043,29,2,2,0,MiniStatement,20210106 12:48:46.156
1044,29,3,3,0,MiniStatementMultiplePages,20210106 12:48:46.156
1045,29,1,0,1,MixedMedia,20210106 12:48:46.156
1046,29,1,0,1,MixedMediaDeposit,20210106 12:48:46.156
1047,29,2,2,0,MultiLanguage,20210106 12:48:46.156
1048,29,2,2,0,NDCPreferences,20210106 12:48:46.156
1049,29,1,1,0,NonGrouping,20210106 12:48:46.156
1050,29,17,16,1,OAR,20210106 12:48:46.156
1051,29,2,2,0,Pinchange,20210106 12:48:46.156
1052,29,59,49,10,Sanity,20210106 12:48:46.156
1053,29,25,24,1,Transfer,20210106 12:48:46.156
1054,29,5,4,1,Unchained,20210106 12:48:46.156
1055,29,31,31,0,UserError,20210106 12:48:46.156
1056,29,22,22,0,Withdrawal,20210106 12:48:46.156
1057,30,23,23,0,Balance,20210107 10:10:44.984
